# NodeManager configuration

NODEMANAGER_DEBUG	LITERAL1
NODEMANAGER_INTERRUPTS	LITERAL1
NODEMANAGER_SLEEP	LITERAL1
NODEMANAGER_RECEIVE	LITERAL1
NODEMANAGER_DEBUG_VERBOSE	LITERAL1
NODEMANAGER_POWER_MANAGER	LITERAL1
NODEMANAGER_CONDITIONAL_REPORT	LITERAL1
NODEMANAGER_EEPROM	LITERAL1
NODEMANAGER_TIME	LITERAL1
NODEMANAGER_RTC	LITERAL1
NODEMANAGER_SD	LITERAL1
NODEMANAGER_HOOKING	LITERAL1
NODEMANAGER_OTA_CONFIGURATION	LITERAL1
NODEMANAGER_SERIAL_INPUT	LITERAL1

# NodeManager classes

NodeManager	KEYWORD1
Sensor	KEYWORD1
Child	KEYWORD1
ConfigurationRequest	KEYWORD1
List	KEYWORD1
PowerManager	KEYWORD1
Timer	KEYWORD1

# NodeManager functions

before	KEYWORD2
celsiusToFahrenheit	KEYWORD2
clearEeprom	KEYWORD2
getAck	KEYWORD2
getAvailableChildId	KEYWORD2
getChild	KEYWORD2
getChildId	KEYWORD2
getDescription	KEYWORD2
getElapsed	KEYWORD2
getFunction	KEYWORD2
getInterruptPin	KEYWORD2
getIsMetric	KEYWORD2
getLastInterruptPin	KEYWORD2
getLastInterruptValue	KEYWORD2
getMode	KEYWORD2
getName	KEYWORD2
getPresentation	KEYWORD2
getRecipientChildId	KEYWORD2
getReportIntervalSeconds	KEYWORD2
getSensorWithChild	KEYWORD2
getSleepSeconds	KEYWORD2
getTime	KEYWORD2
getType	KEYWORD2
getValue	KEYWORD2
getValueFloat	KEYWORD2
getValueDouble	KEYWORD2
getValueString	KEYWORD2
getValueInt	KEYWORD2
getVcc	KEYWORD2
hello	KEYWORD2
interrupt	KEYWORD2
isOver	KEYWORD2
isSleepingNode	KEYWORD2
loadFromMemory	KEYWORD2
loop	KEYWORD2
onInterrupt	KEYWORD2
onLoop	KEYWORD2
onOTAConfiguration	KEYWORD2
onReceive	KEYWORD2
onSetup	KEYWORD2
powerOff	KEYWORD2
powerOn	KEYWORD2
presentation	KEYWORD2
print	KEYWORD2
reboot	KEYWORD2
receive	KEYWORD2
receiveTime	KEYWORD2
registerChild	KEYWORD2
registerSensor	KEYWORD2
reset	KEYWORD2
saveToMemory	KEYWORD2
sendMessage	KEYWORD2
sendValue	KEYWORD2
setAck	KEYWORD2
setADCOff	KEYWORD2
setChildId	KEYWORD2
setDescription	KEYWORD2
setFloatPrecision	KEYWORD2
setForceUpdateTimerValue	KEYWORD2
setGetControllerConfig	KEYWORD2
setInterrupt	KEYWORD2
setInterruptDebounce	KEYWORD2
setInterruptHook	KEYWORD2
setInterruptMode	KEYWORD2
setInterruptStrict	KEYWORD2
setIsMetric	KEYWORD2
setMaxThreshold	KEYWORD2
setMeasureTimerMode	KEYWORD2
setMeasureTimerValue	KEYWORD2
setMinThreshold	KEYWORD2
setMode	KEYWORD2
setPin	KEYWORD2
setPinInitialValue	KEYWORD2
setPostLoopHook	KEYWORD2
setPowerManager	KEYWORD2
setPowerPins	KEYWORD2
setPreLoopHook	KEYWORD2
setPresentation	KEYWORD2
setRebootPin	KEYWORD2
setReceiveHook	KEYWORD2
setReportIntervalDays	KEYWORD2
setReportIntervalHours	KEYWORD2
setReportIntervalMinutes	KEYWORD2
setReportIntervalSeconds	KEYWORD2
setReportTimerMode	KEYWORD2
setReportTimerValue	KEYWORD2
setRetries	KEYWORD2
setSamples	KEYWORD2
setSamplesInterval	KEYWORD2
setSaveSleepSettings	KEYWORD2
setSetupHook	KEYWORD2
setSleepBetweenSend	KEYWORD2
setSleepDays	KEYWORD2
setSleepHours	KEYWORD2
setSleepInterruptPin	KEYWORD2
setSleepMinutes	KEYWORD2
setSleepOrWait	KEYWORD2
setSleepSeconds	KEYWORD2
setSmartSleep	KEYWORD2
setSyncTimeAfterInterval	KEYWORD2
setSyncTimeAfterSleep	KEYWORD2
setSyncTimeOnSetup	KEYWORD2
setTimezone	KEYWORD2
setType	KEYWORD2
setup	KEYWORD2
setValue	KEYWORD2
setValueDelta	KEYWORD2
setWaitAfterInterrupt	KEYWORD2
sleepOrWait	KEYWORD2
start	KEYWORD2
stop	KEYWORD2
syncTime	KEYWORD2
wakeup	KEYWORD2
setPersistValue	KEYWORD2
getPersistValue	KEYWORD2
loadValue	KEYWORD2
loadValue	KEYWORD2
getLastValueInt	KEYWORD2
getLastValueFloat	KEYWORD2
getLastValueDouble	KEYWORD2
getLastValueString	KEYWORD2
setSendWithoutValue	KEYWORD2
registerTimer	KEYWORD2

# NodeManager sensors

Display	KEYWORD1
DisplayHD44780	KEYWORD1
DisplaySSD1306	KEYWORD1
SensorACS712	KEYWORD1
SensorAM2320	KEYWORD1
SensorAnalogInput	KEYWORD1
SensorAPDS9960	KEYWORD1
SensorBattery	KEYWORD1
SensorBH1750	KEYWORD1
SensorBME280	KEYWORD1
SensorBMP085	KEYWORD1
SensorBMP180	KEYWORD1
SensorBMP280	KEYWORD1
SensorBosch	KEYWORD1
SensorChirp	KEYWORD1
SensorConfiguration	KEYWORD1
SensorDHT	KEYWORD1
SensorDHT11	KEYWORD1
SensorDHT22	KEYWORD1
SensorDigitalInput	KEYWORD1
SensorDigitalOutput	KEYWORD1
SensorDimmer	KEYWORD1
SensorDoor	KEYWORD1
SensorDs18b20	KEYWORD1
SensorFPM10A	KEYWORD1
SensorHCSR04	KEYWORD1
SensorHTU21D	KEYWORD1
SensorInterrupt	KEYWORD1
SensorLatchingRelay1Pin	KEYWORD1
SensorLatchingRelay2Pins	KEYWORD1
SensorLDR	KEYWORD1
SensorMCP9808	KEYWORD1
SensorMHZ19	KEYWORD1
SensorML8511	KEYWORD1
SensorMLX90614	KEYWORD1
SensorMotion	KEYWORD1
SensorMQ	KEYWORD1
SensorNeopixel	KEYWORD1
SensorPlantowerPMS	KEYWORD1
SensorPowerMeter	KEYWORD1
SensorPT100	KEYWORD1
SensorPulseMeter	KEYWORD1
SensorRain	KEYWORD1
SensorRainGauge	KEYWORD1
SensorRelay	KEYWORD1
SensorSDS011	KEYWORD1
SensorServo	KEYWORD1
SensorSHT21	KEYWORD1
SensorSHT31	KEYWORD1
SensorSI7021	KEYWORD1
SensorSignal	KEYWORD1
SensorSoilMoisture	KEYWORD1
SensorSonoff	KEYWORD1
SensorThermistor	KEYWORD1
SensorTSL2561	KEYWORD1
SensorTTP	KEYWORD1
SensorVL53L0X	KEYWORD1
SensorWaterMeter	KEYWORD1